                                                                 
                                                                 
                                                                 
   █████████████    █████████████                   ██████████   
   █           █    █           █    ███████████    █        █   
   █           ██████           ██████         █    █        █   
   █                                           ██████        █   
   █           ██████           ██████                       █   
   ████████ ████    ██████████ ██    █         ██████        █   
          █ █                █ █     █         █    ██████████   
          █ █                █ █     █         █                 
          █ █                █ █     ██████ ████                 
       ████ █             ████ █          █ █                    
       █    ██████████    █    ████       █ █                    
       █             █    █       █       █ █                    
       █             ██████       █    ████ █                    
       █                          █    █    █                    
       ████████████████████████ ███    █ ████                    
                              █ █      █ █                       
                              █ █      █ █                       
                              █ █      █ █                       
                            ███ ████████ █                       
                            █            █                       
                            █          F █                       
                            ██████████████                       
                                                                 
                                                                 
                                                                 