                                                                          
                                                                          
                                                                          
   █████████████                                                          
   █           █    █████████████    ██████████████████████               
   █           ██████           ██████                    █               
   █                                          █████████   █               
   █           ██████           ██████        █       █   █               
   ████████ ████    ██████████ ██    ███████ ██       █████               
          █ █                █ █           █ █                            
          █ █                █ █           █ ████              ████████   
          █ █                █ █           █    █              █      █   
       ████ ██████    ████████ ████████████████ ████████████████      █   
       █         █    █                                               █   
       █         █    █        ████████████████ ████████████████    F █   
       █         ██████        █              █ █              ███ ████   
       █                       █              █ █                █ █      
       █         ████████████ ██              █ █                █ █      
       ███████████          █ █       █████████ ████             █ █      
                            █ █       █            ███████████████ █      
                            █ █       █            █               █      
                            █ █████████            █████████████████      
                            █                      █                      
                            ███████████            █                      
                                      ██████████████                      
                                                                          
                                                                          
                                                                          