                                                                 
                                                                 
                                                                 
   █████████████    █████████████                   ██████████   
   █           █    █           █    ███████████    █        █   
   █           ██████           ██████         █    █        █   
   █                                           ██████        █   
   █           ██████           ██████                       █   
   ████████ ████    ██████████ ██    █         ██████        █   
          █ █                █ █     █         █    ██████████   
          █ █                █ █     █         █                 
          █ █                █ █     ██████ ████                 
          █ █                █ █          █ █                    
       ████ ██████████    ████ ████       █ █                    
       █             █    █       █       █ █                    
       █             ██████       █    ████ █                    
       █                          █    █    █                    
       █             ██████       █    █ ████                    
       ███████████████    █████ ███    █ █                       
                              █ █      █ █                       
                              █ █      █ █                       
                              █ █      █ █                       
                            ███ ████████ █                       
                            █            █                       
                            █          F █                       
                            ██████████████                       
                                                                 
                                                                 
                                                                 