                                                                          
                                                                          
                                                                          
   █████████████    █████████████                  █████████              
   █           █    █           █    ██████████    █       █              
   █           ██████           ██████        █    █       █              
   █    █                                     █    █ ███████              
   █           ██████           ██████        █    █ █                    
   ████████ ████    ██████████ ██    █        █    █ █                    
          █ █                █ █     ███████ ██    █ █                    
          █ █                █ █           █ ███████ ██████    ████████   
          █ █                █ █           █              █    █      █   
       ████ ██████████████████ █           ████ █████████ ██████      █   
       █                       █              █ █       █             █   
       █    F                  █              █ █       ████████      █   
       █                       █              █ █              ████████   
       █                       █              █ █                         
       █████████████████████████      █████████ ████                      
                                      █            █                      
                                      █            █                      
                                      █            █                      
                                      █            █                      
                                      █            █                      
                                      █            █                      
                                      ██████████████                      
                                                                          
                                                                          
                                                                          