                                                             
                                                             
                                                             
   █████████    ████████████████████████████                 
   █       █    █                          █                 
   █       █    █ ████████                 ████              
   █       █    █ ███    █                    ████           
   ██ ██████    █   █    ██████████  █           █           
    █ █         ███ █             ████ █████████ █           
    █ █           █ █                █ █       █ █           
    █ █           █ █                █ █       █ ██████      
    █ █████       █ █                █ █       █      ████   
   ██     █       █ █████    █████████ █       █         █   
   █      █████████     ██████      ██ ███     █         █   
   █                                     █     █████ █████   
   █      ███████     █████████          █         █ █       
   █      █     ███ ████      ██████     █         █ █       
   █   ████       █    █         █       ███████████ █       
   █████          ████ █         ███  F              █       
                     █ █           █     ███████████ █       
                     █ █           ███████         █ █       
          ███████    █ █                           █ █       
          █     █    █ ███████                     █ █       
          █     ██████       █                ██████ █       
          █            █████ ███████████      █   ██ ██      
          ██████████████   █ █         ████████       █      
                           █                          █      
                           ████████████████████████████      
                                                             
                                                             
                                                             
