                                                         
                                                         
                                                         
   █████████                                             
   █       ██████████████                                
   █                    █                                
   █       ██████       ████████████████                 
   █████████    █                      █      █████      
                █           ██████████ █      █   █      
                ███ █████████        █ ████████   ██     
                  █ █                █             █     
                  █ █                █ ████████    █     
   ████████       █ █                █ █      █    ███   
   █      █       █ █                █ █      █      █   
   █      █████████ ██████████████████ ███    ████████   
   █                                     █               
   █      ███████     █████████          █               
   █ F    █     ███ ███       ████       █               
   ████████       █ █            █       █               
                  █ █            █████████               
                  █ █                                    
                ███ █████████                            
                █           █                            
                █           █                            
                █████████████                            
                                                         
                                                         
                                                         