                                                          
                                                          
                                                          
   █████████             ██████████████████████           
   █       ███████████████                    █           
   █                                          █           
   █       ██████ ████████       ███          █           
   █       █    █ ███    █       █            ████        
   ██ ██████    █   █    █       █   █           █        
    █ █         ███ █    █████████████ █████████ █        
    █ █           █ █                █ █       █ █        
    █ █           █ █                █ █       █ ██████   
    █ █           █ █                █ █       █    F █   
   ██ █████       █ █                █ █       █      █   
   █      █████████ ██████████████████ ███     █      █   
   █                                     █     █████ ██   
   █      ███████     █████████          █         █ █    
   █      █     ███ ███       ██████     █         █ █    
   ████████       █ █            █       ███████████ █    
                  █ █            ███                 █    
                  █ █              █     █████████████    
                ███ █████          █     █                
                █       █          ███████                
            █████       █                                 
            █           ██████                            
            █                █                            
            ██████████████████                            
                                                          
                                                          
                                                          