                           
                           
                           
   █████████████████████   
   █                   █   
   █                   █   
   █                   █   
   █                   █   
   █████████           █   
           █           █   
           █           █   
           █           █   
           █████████████   
                           
                           
                           